type octile
height 50
width 50
map
..................................................
......TTTTTTTTTT.TTTTTTTTTT.TTTTTTTTTT.TTTTT......
......TTTTTTTTTT.TTTTTTTTTT.TTTTTTTTTT.TTTTT......
..................................................
......TTTTTTTTTT.TTTTTTTTTT.TTTTTTTTTT.TTTTT......
......TTTTTTTTTT.TTTTTTTTTT.TTTTTTTTTT.TTTTT......
..................................................
......TTTTTTTTTT.TTTTTTTTTT.TTTTTTTTTT.TTTTT......
......TTTTTTTTTT.TTTTTTTTTT.TTTTTTTTTT.TTTTT......
..................................................
......TTTTTTTTTT.TTTTTTTTTT.TTTTTTTTTT.TTTTT......
......TTTTTTTTTT.TTTTTTTTTT.TTTTTTTTTT.TTTTT......
..................................................
......TTTTTTTTTT.TTTTTTTTTT.TTTTTTTTTT.TTTTT......
......TTTTTTTTTT.TTTTTTTTTT.TTTTTTTTTT.TTTTT......
..................................................
......TTTTTTTTTT.TTTTTTTTTT.TTTTTTTTTT.TTTTT......
......TTTTTTTTTT.TTTTTTTTTT.TTTTTTTTTT.TTTTT......
..................................................
......TTTTTTTTTT.TTTTTTTTTT.TTTTTTTTTT.TTTTT......
......TTTTTTTTTT.TTTTTTTTTT.TTTTTTTTTT.TTTTT......
..................................................
......TTTTTTTTTT.TTTTTTTTTT.TTTTTTTTTT.TTTTT......
......TTTTTTTTTT.TTTTTTTTTT.TTTTTTTTTT.TTTTT......
..................................................
......TTTTTTTTTT.TTTTTTTTTT.TTTTTTTTTT.TTTTT......
......TTTTTTTTTT.TTTTTTTTTT.TTTTTTTTTT.TTTTT......
..................................................
......TTTTTTTTTT.TTTTTTTTTT.TTTTTTTTTT.TTTTT......
......TTTTTTTTTT.TTTTTTTTTT.TTTTTTTTTT.TTTTT......
..................................................
......TTTTTTTTTT.TTTTTTTTTT.TTTTTTTTTT.TTTTT......
......TTTTTTTTTT.TTTTTTTTTT.TTTTTTTTTT.TTTTT......
..................................................
......TTTTTTTTTT.TTTTTTTTTT.TTTTTTTTTT.TTTTT......
......TTTTTTTTTT.TTTTTTTTTT.TTTTTTTTTT.TTTTT......
..................................................
......TTTTTTTTTT.TTTTTTTTTT.TTTTTTTTTT.TTTTT......
......TTTTTTTTTT.TTTTTTTTTT.TTTTTTTTTT.TTTTT......
..................................................
......TTTTTTTTTT.TTTTTTTTTT.TTTTTTTTTT.TTTTT......
......TTTTTTTTTT.TTTTTTTTTT.TTTTTTTTTT.TTTTT......
..................................................
......TTTTTTTTTT.TTTTTTTTTT.TTTTTTTTTT.TTTTT......
......TTTTTTTTTT.TTTTTTTTTT.TTTTTTTTTT.TTTTT......
..................................................
......TTTTTTTTTT.TTTTTTTTTT.TTTTTTTTTT.TTTTT......
......TTTTTTTTTT.TTTTTTTTTT.TTTTTTTTTT.TTTTT......
..................................................
......TTTTTTTTTT.TTTTTTTTTT.TTTTTTTTTT.TTTTT......
