type octile
height 30
width 30
map
..............................
......TTTTTTTTTT.TTTTTTT......
......TTTTTTTTTT.TTTTTTT......
..............................
......TTTTTTTTTT.TTTTTTT......
......TTTTTTTTTT.TTTTTTT......
..............................
......TTTTTTTTTT.TTTTTTT......
......TTTTTTTTTT.TTTTTTT......
..............................
......TTTTTTTTTT.TTTTTTT......
......TTTTTTTTTT.TTTTTTT......
..............................
......TTTTTTTTTT.TTTTTTT......
......TTTTTTTTTT.TTTTTTT......
..............................
......TTTTTTTTTT.TTTTTTT......
......TTTTTTTTTT.TTTTTTT......
..............................
......TTTTTTTTTT.TTTTTTT......
......TTTTTTTTTT.TTTTTTT......
..............................
......TTTTTTTTTT.TTTTTTT......
......TTTTTTTTTT.TTTTTTT......
..............................
......TTTTTTTTTT.TTTTTTT......
......TTTTTTTTTT.TTTTTTT......
..............................
......TTTTTTTTTT.TTTTTTT......
......TTTTTTTTTT.TTTTTTT......
