type octile
height 40
width 40
map
........................................
......TTTTTTTTTT.TTTTTTTTTT.TTTTTT......
......TTTTTTTTTT.TTTTTTTTTT.TTTTTT......
........................................
......TTTTTTTTTT.TTTTTTTTTT.TTTTTT......
......TTTTTTTTTT.TTTTTTTTTT.TTTTTT......
........................................
......TTTTTTTTTT.TTTTTTTTTT.TTTTTT......
......TTTTTTTTTT.TTTTTTTTTT.TTTTTT......
........................................
......TTTTTTTTTT.TTTTTTTTTT.TTTTTT......
......TTTTTTTTTT.TTTTTTTTTT.TTTTTT......
........................................
......TTTTTTTTTT.TTTTTTTTTT.TTTTTT......
......TTTTTTTTTT.TTTTTTTTTT.TTTTTT......
........................................
......TTTTTTTTTT.TTTTTTTTTT.TTTTTT......
......TTTTTTTTTT.TTTTTTTTTT.TTTTTT......
........................................
......TTTTTTTTTT.TTTTTTTTTT.TTTTTT......
......TTTTTTTTTT.TTTTTTTTTT.TTTTTT......
........................................
......TTTTTTTTTT.TTTTTTTTTT.TTTTTT......
......TTTTTTTTTT.TTTTTTTTTT.TTTTTT......
........................................
......TTTTTTTTTT.TTTTTTTTTT.TTTTTT......
......TTTTTTTTTT.TTTTTTTTTT.TTTTTT......
........................................
......TTTTTTTTTT.TTTTTTTTTT.TTTTTT......
......TTTTTTTTTT.TTTTTTTTTT.TTTTTT......
........................................
......TTTTTTTTTT.TTTTTTTTTT.TTTTTT......
......TTTTTTTTTT.TTTTTTTTTT.TTTTTT......
........................................
......TTTTTTTTTT.TTTTTTTTTT.TTTTTT......
......TTTTTTTTTT.TTTTTTTTTT.TTTTTT......
........................................
......TTTTTTTTTT.TTTTTTTTTT.TTTTTT......
......TTTTTTTTTT.TTTTTTTTTT.TTTTTT......
........................................
